SSSSSSSSSSSSSSSSSSSSSSSSSSSSSSSSSSSSSSSSSSSSSSSSSSSSSSSSSSSSSSSS
SSSSSSSSSSSSSSSSSSSSSSSSSSSSSSSSSSSSSSSSSSSSSSSSSSSSSSSSSSSSSSSS
SSSSSSSSSSSSSSSSSSSSSSSSSSSSSSSSSSSSSSSSSSSSSSSSSSSSSSSSSSSSSSSS
SSSSSSSSSSSSSSSSSSSSSSSSSSSSSSSSSSSSSSSSSSSSSSSSSSSSSSSSSSSSSSSS
SSSSSSSSSSSSSSSSSSSSSSIIIIIISIIISIIISSSSSSSSSSSSSSSSSSSSSSSSSSSS
SSSSSSSSSSSSSIIIIIIIIIIIIIIISIIIIIIIIIIIIIIISSSSSSSSSSSSSSSSSSSS
SSSSSSSSSSSSSIIIIIIIIIIIIIIISIIIIIIIIIIIIIIIISSSSSSSSSSSSSSSSSSS
SSSSSSSSSSSSSIIIIIIIIIIIIIIIIIIIIIIIIIIIIIIIIISSSSSSSSSSSSSSSSSS
SSSSSSSSSSSSSIIIIIIIIIIIIIIIIIIIIIIIIIIIIIIIIIIISSSSSSSSSSSSSSSS
SSSSSSSSSSSSSIIIIIIIIIIIIIIIIIIIIIIIIIIIIIIIIIIISSSSSSSSSSSSSSSS
SSSSSSSSSSSSIIIIIIIIIIIIIIIIIIIIIIIIIIIIIIIIIIIISSSSSSSSSSSSSSSS
SSSSSSSSSSSSIIIIIIIIIIIIIIIIIIIIIIIIIIIIIIIIIIIISSSSSSSSSSSSSSSS
SSSSSSSSSSSSIIIIIIIIIIIIIIIIIIIIIIIIIIIIIIIIIIIISSSSSSSSSSSSSSSS
SSSSSSSSSSSIIIIIIIIIIIIIIIIIIIIIIIIIIIIIIIIIIIIISSSSSSSSSSSSSSSS
SSSSSSSSSSSIIIIIIIIIIIIIIIIIIIIIIIIIIIIIIIIIIIIISSSSSSSSSSSSSSSS
SSSSSSSSSSSIIIIIIIIIIIIIIIIIIIIIIIIIIIIIIIIIIIIISSSSSSSSSSSSSSSS
SSSSSSSSSSSIIIIIIIIIIIIIIIIIIIIIIIIIIIIIIIIIIIIISSSSSSSSSSSSSSSS
SSSSSSSSSSSIIIIIIIIIIIIIIIIIIIIIIIIIIIIIIIIIIIIISSSSSSSSSSSSSSSS
SSSSSSSSSSSIIIIIIIIIIIIIIIISIIIIIIIIIIIIIIIIIIIISSSSSSSSSSSSSSSS
SSSSSSSSSSSIIIIIIIIIIIIIIISSSIIIIIIIIIIIIIIIIIIISSSSSSSSSSSSSSSS
SSSSSSSSSSSIIIIIIIIIIIIISSSSSSIIIIIIIIIIIIIIIIIISSSSSSSSSSSSSSSS
SSSSSSSSSSSIIIIIIIIIIIISSSSSSSSIIIIIIIIIIIIIIIIISSSSSSSSSSSSSSSS
SSSSSSSSSSSIIIIIIIIIIIIISSSSSSIIIIIIIIIIIIIIIIIISSSSSSSSSSSSSSSS
SSSSSSSSSSSSIIIIIIIIIIIIIISSSIIIIIIIIIIIIIIIIIIISSSSSSSSSSSSSSSS
SSSSSSSSSSSIIIIIIIIIIIIIIIISIIIIIIIIIIIIIIIIIIISSSSSSSSSSSSSSSSS
SSSSSSSSSSSIIIIIIIIIIIIIIIIIIIIIIIIIIIIIIIIIIIIISSSSSSSSSSSSSSSS
SSSSSSSSSSSIIIIIIIIIIIIIIIIIIIIIIIIIIIIIIIIIIIIISSSSSSSSSSSSSSSS
SSSSSSSSSSSIIIIIIIIIIIIIIIIIIIIIIIIIIIIIIIIIIIIISSSSSSSSSSSSSSSS
SSSSSSSSSSSSSSSSIIIIIIIIIIIIIIIIIIIIIIIIIIIIISSSSSSSSSSSSSSSSSSS
SSSSSSSSSSSIIIIIIIIIIIIIIIIIIIIIIIIIIIIIIIIIIIIISSSSSSSSSSSSSSSS
SSSSSSSSSSSIIIIIIIIIIIIIIIIIIIIIIIIIIIIIIIIIIIIISSSSSSSSSSSSSSSS
SSSSSSSSSSSIIIIIIIIIIIIIIIIIIIIIIIIIIIIIIIIIIIIISSSSSSSSSSSSSSSS
SSSSSSSSSSSIIIIIIIIIIIIIIIIIIISSSIIIIIIIIIIIIIIISSSSSSSSSSSSSSSS
SSSSSSSSSSSIIIIIIIIIIIIIIIIIIISSSSIIIIIIIIIISSSSSSSSSSSSSSSSSSSS
SSSSSSSSSSSIIIIIIIIIIIIIIIIIIIIIIIIIIIIIIIIISSSSSSSSSSSSSSSSSSSS
SSSSSSSSSSSIIIIIIIIIIIIIIIIIIIIIIIIIIIIIIIIISSSSSSSSSSSSSSSSSSSS
SSSSSSSSSSSSIIIIIIIIIISIIIIIIIISIIIIIIIIIIIISSSSSSSSSSSSSSSSSSSS
SSSSSSSSSSSSSIIIIIIIIISIIIIIIISSSIIIIIIIIIIISSSSSSSSSSSSSSSSSSSS
SSSSSSSSSSSSSSSSSSSSSSSSSSSSSSSSSSSSSSSSSSSSSSSSSSSSSSSSSSSSSSSS
SSSSSSSSSSSSSSSSSSSSSSSSSSSSSSSSSSSSSSSSSSSSSSSSSSSSSSSSSSSSSSSS
SSSSSSSSSSSSSSSSSSSSSSSSSSSSSSSSSSSSSSSSSSSSSSSSSSSSSSSSSSSSSSSS
SSSSSSSSSSSSSSSSSSSSSSSSSSSSSSSSSSSSSSSSSSSSSSSSSSSSSSSSSSSSSSSS
SSSSSSSSSSSSSSSSSSSSSSSSSSSSSSSSSSSSSSSSSSSSSSSSSSSSSSSSSSSSSSSS
SSSSSSSSSSSSSSSSSSSSSSSSSSSSSSSSSSSSSSSSSSSSSSSSSSSSSSSSSSSSSSSS
SSSSSSSSSSSSSSSSSSSSSSSSSSSSSSSSSSSSSSSSSSSSSSSSSSSSSSSSSSSSSSSS
SSSSSSSSSSSSSSSSSSSSSSSSSSSSSSSSSSSSSSSSSSSSSSSSSSSSSSSSSSSSSSSS
SSSSSSSSSSSSSSSSSSSSSSSSSSSSSSSSSSSSSSSSSSSSSSSSSSSSSSSSSSSSSSSS
SSSSSSSSSSSSSSSSSSSSSSSSSSSSSSSSSSSSSSSSSSSSSSSSSSSSSSSSSSSSSSSS